11111111111111111111111111111111
1C00P111111111111111111111111101
1000CE00000000000000000000011101
11100000000000000000000011101111
11111111CCCCCC111111111111111101
11111100000000000000000000011111
11100000000000000000000011111011
11111111000000000000000000111101
11111111110000000000000000011101
11111110000000000000000011111101
11111111CCCCCC111101111111110111
1111CCCCCC1101110111111111011111
111111CCCCCC11111111111111111111
111111CCCCCC11011111111111110111
1111111CCCCC11111111111111111101
11111111111111110111111111111101
11111111111111111111111111111111