1111111
1C0EP11
1000C01
1111111