11111111111111111111111111111111
1C00P111111111111111111111111101
1000CE11111111111111111111111101
11111111111111111111111111111101
11111111111111111111111111111101
11111111111111111111111111111101
11111111111111111111111111111101
11111111111111111111111111111101
11111111111111111111111111111101
11111111111111111111111111111101
11111111111111111111011111111101
11111111111111110111011111111101
11111111111111111111111111111111
11111111111111110111111111111101
11111111111111111111111111111101
11111111111111110111111111111101
11111111111111111111111111111111