1111111
1C00P11
1000CE1
1110011
1111111
