1111111111
1C0000C111
1000CE0111
100P000011
1111111111
