11111111111
1CC11C11CC1
10000000EP1
10001C10111
11111111111