1111111111111111111111
1000C111C11E111C111C11
1CX10010001C110000X001
1001000000000000000001
10010000000X0000000001
100100X0010011X0100C11
11P11111111C11C0111111
1111111111111111111111