1111111111111111
1CC11C11CCX0CC01
1E0000000P00CC01
10000CC01100CC01
10000CC01100CC01
10C0CC01100CC011
10C0CC01100CC011
10C0CC01100CC011
10C0CC01100CC011
10CCCC01100CC011
10CXCC01100CC011
10C1CC011X0CC011
1111111111111111