1111111111111111
1CC11C11CCX0CC01
1E0000000P00CC01
10000CC011X0CC01
10000CC011X0CC01
10C0CC01100CC011
1XC0CC01100CC011
10C0CC01100CC011
10C0CC01100CC011
10CCCC011X0CC011
1XCXCC01100CC011
10C1CC011X0CC011
1111111111111111