1111111111111111
1CC11C11CC00CC01
10000000EP00CC01
10000CC01100CC01
10000CC01100CC01
10000CC01100CC01
1111111111111111