111111111111111
1000C000C000C01
11111100P001001
1E000000C000111
111111111111111