111111111
11ECC0P11
1X0000111
100101001
111111111